org.argouml.state2.diagram.UMLStateDiagram	u m l state diagram u m l state diagram u m l state diagram initialize create graph model property change get uml actions get label name get node action get pseudo action get edge action get label relocate encloser changed does accept create diagram element is relocation allowed get relocation candidates create pseudostate action 
org.argouml.transformer.SimpleStateTransformer$SimpleStateToCompositeState	simple state to composite state simple state to composite state action performed make transition set ports set source port set dest port get node presentation for 
org.argouml.uml.diagram.activity.ui.ActivityDiagramRenderer	activity diagram renderer l o g get fig node for get fig edge for 
org.argouml.uml.diagram.activity.ui.UMLActivityDiagram	u m l activity diagram l o g serial version u i d the activity graph action state action start pseudo state action final pseudo state action junction pseudo state action fork pseudo state action join pseudo state action transition action object flow state action swimlane action call state action subactivity state action call event action change event action signal event action time event action guard action call action action create action action destroy action action return action action send action action terminate action action uninterpreted action action action sequence u m l activity diagram u m l activity diagram initialize setup create graph model property change get owner get state machine set state machine get uml actions get trigger actions get effect actions get label name get action call state get action final pseudo state get action fork pseudo state get action join pseudo state get action junction pseudo state get action swimlane get action object flow state get action start pseudo state get action state get action subactivity state get action transition get action call event get action change event get action signal event get action time event get action guard get action call action get action create action get action destroy action get action return action get action send action get action terminate action get action uninterpreted action get action action sequence get dependent element is relocation allowed get relocation candidates relocate post load encloser changed change partition is state in partition does accept create diagram element 
org.argouml.uml.diagram.collaboration.ui.CollabDiagramRenderer	collab diagram renderer l o g get fig node for get fig edge for get fig node for association end 
org.argouml.uml.diagram.collaboration.ui.FigAssociationRole	fig association role messages fig association role get notation provider type add message compute route impl fig message group fig message group update fig positions calc bounds add fig update arrows 
org.argouml.uml.diagram.collaboration.ui.UMLCollaborationDiagram	u m l collaboration diagram l o g action classifier role action generalize action connector action association action aggregation action composition action uni association action uni aggregation action uni composition action depend action message u m l collaboration diagram u m l collaboration diagram get num messages set namespace create graph model get uml actions get association actions post load get label name get action classifier role get action association get action connector get action composition get action depend get action generalize get action uni aggregation get action uni association get action uni composition get action aggregation get action message is relocation allowed relocate get relocation candidates encloser changed does accept make new c r make new fig c r drop create diagram element get instructions serial version u i d 
org.argouml.uml.diagram.deployment.ui.AbstractFigNode	abstract fig node d e p t h cover d e f a u l t  x d e f a u l t  y d e f a u l t  w i d t h d e f a u l t  h e i g h t create big port fig init figs abstract fig node clone set line color set line width is filled set filled make selection get minimum size set standard bounds mouse clicked set enclosing fig get use trap rect model changed update listeners get closest point 
org.argouml.uml.diagram.deployment.ui.DeploymentDiagramRenderer	deployment diagram renderer serial version u i d l o g get fig node for get fig edge for 
org.argouml.uml.diagram.deployment.ui.FigComponent	fig component fig component text edit started make selection set enclosing fig get pop up actions 
org.argouml.uml.diagram.deployment.ui.FigComponentInstance	fig component instance fig component instance get notation provider type clone update listeners make selection mouse clicked mouse pressed set enclosing fig 
org.argouml.uml.diagram.deployment.ui.FigMNode	fig m node fig m node text edit started get pop up actions 
org.argouml.uml.diagram.deployment.ui.FigNodeInstance	fig node instance fig node instance get notation provider type clone make selection set enclosing fig 
org.argouml.uml.diagram.deployment.ui.UMLDeploymentDiagram	u m l deployment diagram l o g action m node action m node instance action m component action m component instance action m class action m interface action m object action m dependency action m association action m link action association action aggregation action composition action uni association action uni aggregation action uni composition action m generalization action m abstraction u m l deployment diagram u m l deployment diagram set namespace create graph model get uml actions get association actions serial version u i d get label name get action aggregation get action association get action composition get action m association get action m class get action m component get action m component instance get action m dependency get action m generalization get action m abstraction get action m interface get action m link get action m node get action m node instance get action m object get action uni aggregation get action uni association get action uni composition is relocation allowed get relocation candidates relocate set model element namespace encloser changed does accept create diagram element 
org.argouml.uml.diagram.state.ui.FigTransition	fig transition end arrow dashed fig transition initialize transition set layer init ports get notation provider type rendering changed update dashed get pop up actions set fig get destination get source paint 
org.argouml.uml.diagram.state.ui.StateDiagramRenderer	state diagram renderer l o g get fig node for get fig edge for 
org.argouml.uml.diagram.state.ui.UMLStateDiagram	u m l state diagram serial version u i d l o g the state machine action stub state action state action synch state action submachine state action composite state action start pseudo state action final pseudo state action branch pseudo state action fork pseudo state action join pseudo state action shallow history pseudo state action deep history pseudo state action call event action change event action signal event action time event action guard action call action action create action action destroy action action return action action send action action terminate action action uninterpreted action action action sequence action transition action junction pseudo state u m l state diagram u m l state diagram u m l state diagram name diagram get namespace from machine get owner initialize setup create graph model property change get state machine set state machine get uml actions get trigger actions get effect actions get label name get action choice pseudo state get action composite state get action deep history pseudo state get action final pseudo state get action fork pseudo state get action join pseudo state get action junction pseudo state get action shallow history pseudo state get action start pseudo state get action state get action synch state get action submachine state get action stub state get action transition get action call event get action change event get action signal event get action time event get action guard get action call action get action create action get action destroy action get action return action get action send action get action terminate action get action uninterpreted action get action action sequence get dependent element is relocation allowed get relocation candidates relocate encloser changed does accept drop create diagram element 
org.argouml.uml.diagram.static_structure.layout.ClassdiagramModelElementFactory	classdiagram model element factory l o g s i n g l e t o n classdiagram model element factory get instance 
org.argouml.uml.diagram.static_structure.ui.FigLink	fig link middle group initialize fig link can edit update listeners notation rendering changed update layout update name text get destination get source 
org.argouml.uml.diagram.static_structure.ui.UMLClassDiagram	u m l class diagram serial version u i d l o g action association class action class action interface action instance specification action dependency action permission action usage action link action generalization action realization action package action model action subsystem action association action association end action aggregation action composition action uni association action uni aggregation action uni composition action data type action enumeration action stereotype action signal action exception u m l class diagram u m l class diagram u m l class diagram set namespace get uml actions get data type actions get package actions get dependency actions get association actions get aggregation actions get composition actions get label name get action aggregation get action association get action association end get action class get action association class get action composition get action dependency get action generalization get action interface get action instance specification get action link get action model get action package get action permission get action realization get action subsystem get action uni aggregation get action uni association get action uni composition get action usage get action data type get action enumeration get action stereotype get action signal get action exception is relocation allowed get relocation candidates relocate encloser changed does accept create diagram element get fig node for association end get node presentation for 
org.argouml.uml.diagram.ui.FigAbstraction	fig abstraction create end arrow fig abstraction 
org.argouml.uml.diagram.ui.FigAssociation$EndDecoration	end decoration group mult end decoration get group get mult get role get arrow type rendering changed init notation providers get owner 
org.argouml.uml.diagram.ui.FigAssociation	fig association l o g src end dest end middle group fig association remove from diagram impl property change create end figs create end create name label rendering changed init notation providers initialize notation providers internal update listeners get notation provider type get source get destination get source connector get destination connector text edited text edit started apply arrow heads get pop up actions is point close to edge end build multiplicity menu build navigation menu build aggregation menu update multiplicity paint get middle group layout edge update name text end decoration fig multiplicity fig multiplicity get notation provider type fig ordering serial version u i d fig ordering set text get ordering name fig role fig role get notation provider type property change fig association end annotation serial version u i d n a v  a g g r n a v  c o m p n o n e a g g r e g a t e c o m p o s i t e n a v a r r o w  h e a d s   role ordering fig edge fig association end annotation remove from diagram property change get arrow type get role 
org.argouml.uml.diagram.ui.FigAssociationClass	fig association class serial version u i d fig association class create name label remove from diagram impl set fig get name fig is path visible set path visible set fill color get fill color set line color get association class get fig edge association class 
org.argouml.uml.diagram.ui.FigAssociationEnd	fig association end dest group dest mult fig association end get notation provider type init notation providers initialize notation providers internal init notation arguments update listeners text edited text edit started rendering changed update stereotype text update multiplicity 
org.argouml.uml.diagram.ui.FigDependency	fig dependency serial version u i d middle group construct figs create end arrow fig dependency set fig can edit update name text update stereotype text 
org.argouml.uml.diagram.ui.FigEdgeAssociationClass	fig edge association class serial version u i d l o g construct figs fig edge association class fig edge association class fig edge association class set fig can edit model changed get remove delegate set dest fig node set source fig node 
org.argouml.uml.diagram.ui.FigEdgeModelElement	fig edge model element l o g di element remove from diagram popup add offset notation provider name name fig stereotype fig edge port item uid listeners settings fig edge model element init figs init owner make edge port get edge port set item u i d get item u i d get tip string get pop up actions get apply stereotype actions get squared distance paint clarifiers hit clarifier make selection get name fig get name bounds get name get stereotype fig vetoable change delayed vetoable change property change     model attribute changed model association added model association removed update layout text edit started show help text edited can edit mouse pressed mouse released mouse entered mouse exited mouse clicked is read only key pressed key released key typed rendering changed model changed update name text update stereotype text init notation providers get notation provider type update listeners set layer delete from model notation changed notation added notation removed notation provider added notation provider removed hit remove from diagram get remove delegate remove from diagram impl super remove from diagram damage determine fig nodes get no edge presentation for layout this to self get source get source connector get destination connector get destination allow remove from diagram set di element get di element get popup add offset add element listener add element listener add element listener remove element listener remove all element listeners remove element listeners add element listeners update element listeners set project get project diagram font changed update font get name fig font style deep update font deep update font recursive get settings set settings get notation settings set line color set fig set owner compute route impl notation rendering changed get notation settings get owner 
org.argouml.uml.diagram.ui.FigGeneralization	fig generalization t e x t  h e i g h t d i s c r i m i n a t o r  w i d t h serial version u i d middle group discriminator end arrow initialize fig generalization can edit model changed update listeners add listener update discriminator text paint fixup 
org.argouml.uml.diagram.ui.FigNodeAssociation	fig node association x y head create big port fig init figs fig node association clone update layout reduce to binary get gravity points set line color get line color set fill color get fill color set filled is filled set line width get line width set standard bounds get minimum size remove from diagram impl 
org.argouml.uml.diagram.ui.FigPermission	fig permission fig permission 
org.argouml.uml.diagram.ui.FigUsage	fig usage fig usage 
org.argouml.uml.diagram.ui.ModeCreateAssociationClass	mode create association class serial version u i d l o g d i s t a n c e get meta type end attached build in active layer build parts 
org.argouml.uml.diagram.ui.ModeCreateAssociationEnd	mode create association end serial version u i d get meta type build connection convert to fig node is connection valid 
org.argouml.uml.diagram.ui.SelectionRerouteEdge	selection reroute edge source fig dest fig armed point index selection reroute edge mouse pressed mouse dragged mouse released 
org.argouml.uml.diagram.ui.StylePanelFigAssociationClass	style panel fig association class attr check box oper check box refresh transaction style panel fig association class has editable bounding box set target b box refresh refresh item state changed 
